54
10 9 10 10 10 11 10 12 10 13 10 14 10 15 10 16 10 17 11 13 12 13 13 13 14 9 14 10 14 11 14 12 14 13 14 14 14 15 14 16 14 17 18 11 18 12 18 13 18 14 18 15 18 16 18 17 19 11 19 14 19 17 20 11 20 14 20 17 21 11 21 14 21 17 23 11 23 12 24 13 25 14 25 15 25 16 25 17 26 13 27 11 27 12 31 11 31 12 31 13 31 14 31 15 31 16 31 18 0
66
10 9 10 10 10 11 10 12 10 13 10 14 10 15 10 16 10 17 11 13 12 13 13 13 14 9 14 10 14 11 14 12 14 13 14 14 14 15 14 16 14 17 18 11 18 12 18 13 18 14 18 15 18 16 18 17 18 22 18 26 19 11 19 14 19 17 19 22 19 23 19 24 19 25 19 26 20 11 20 14 20 17 20 22 20 26 21 11 21 14 21 17 23 11 23 12 24 13 24 25 24 26 25 14 25 15 25 16 25 17 25 26 26 13 27 11 27 12 31 11 31 12 31 13 31 14 31 15 31 16 31 18 0
94
10 9 10 10 10 11 10 12 10 13 10 14 10 15 10 16 10 17 11 13 12 13 13 13 14 9 14 10 14 11 14 12 14 13 14 14 14 15 14 16 14 17 18 11 18 12 18 13 18 14 18 15 18 16 18 17 18 22 18 26 19 11 19 14 19 17 19 22 19 23 19 24 19 25 19 26 20 11 20 14 20 17 20 22 20 26 21 11 21 14 21 17 22 22 22 23 23 11 23 12 23 21 23 22 23 23 23 24 23 25 23 26 24 13 24 22 24 23 24 24 24 25 25 14 25 15 25 16 25 17 25 23 25 24 25 25 25 26 26 13 26 23 26 24 26 25 26 26 27 11 27 12 27 22 27 23 27 24 27 25 28 21 28 22 28 23 28 24 29 22 29 23 29 24 31 11 31 12 31 13 31 14 31 15 31 16 31 18 0
65
10 9 10 10 10 11 10 12 10 13 10 14 10 15 10 16 10 17 11 13 12 13 13 13 14 9 14 10 14 11 14 12 14 13 14 14 14 15 14 16 14 17 18 11 18 12 18 13 18 14 18 15 18 16 18 17 19 11 19 14 19 17 20 11 20 14 20 17 21 11 21 14 21 17 23 11 23 12 23 21 23 27 24 13 24 21 24 22 24 23 24 24 24 25 24 26 24 27 25 14 25 15 25 16 25 17 25 21 25 27 26 13 27 11 27 12 31 11 31 12 31 13 31 14 31 15 31 16 31 18 0
117
10 9 10 10 10 11 10 12 10 13 10 14 10 15 10 16 10 17 11 13 12 13 13 13 14 9 14 10 14 11 14 12 14 13 14 14 14 15 14 16 14 17 18 11 18 12 18 13 18 14 18 15 18 16 18 17 19 11 19 14 19 17 20 11 20 14 20 17 21 11 21 14 21 17 23 11 23 12 23 21 23 27 24 13 24 21 24 22 24 23 24 24 24 25 24 26 24 27 25 14 25 15 25 16 25 17 25 21 25 27 26 13 27 11 27 12 29 22 29 23 30 21 30 22 30 23 30 24 31 11 31 12 31 13 31 14 31 15 31 16 31 18 31 21 31 22 31 23 31 24 31 25 32 22 32 23 32 24 32 25 32 26 33 23 33 24 33 25 33 26 33 27 34 22 34 23 34 24 34 25 34 26 35 21 35 22 35 23 35 24 35 25 36 21 36 22 36 23 36 24 37 22 37 23 41 21 41 22 41 23 41 24 41 25 41 26 42 27 43 27 44 27 45 21 45 22 45 23 45 24 45 25 45 26 0

